20 EHCI=2.0 (EHCI)
30 nec XHCI=3.0 (nec XHCI)
30 qemu XHCI=3.0 (qemu XHCI)
Allocation=Przydział
and if using graphics device passthrough it too needs UEFI=i jeśli używa bezpośredniego połączenia do karty graficznej, też potrzebuje UEFI
Are you sure=Czy ma pewno
Array must be started to view Virtual Machines=Macierz musi być **uruchomiona** by przeglądać maszyny wirtualne
Autostart=Autostart
Back=Wstecz
Bus=Szyna
Capacity=Pojemność
Change Icon=Zmień ikonę
Cleanup=Czyszczenie
Click and Select cdrom image to install operating system=Kliknij i wybierz obraz płyty by zainstalować system operacyjny
Config Folder=Katalog konfiguracyjny
Copy Paste Domain XML Configuration Here=Wklej tutaj XML z konfiguracją domeny
CPU Mode=Tryb procesora
CPUs=Procesory
Create=Utwóz
Creating=Tworzę
define the amount memory=zdefiniuj ilość pamięci
define the maximum amount of memory=zdefiniuj maksymalną ilość pamięci
define type of cpu presented to this vm=zdefiniuj typ procesora udostępniany tej maszynie
description of virtual machine=opis maszyny wirtualnej
Disk devices=Urządzenia dyskowe
Download Folder=Katalog pobierania
Download, Click and Select virtio drivers image=Pobierz, kliknij i wybierz obraz ze sterownikami virtio
Downloading=Pobieranie
eg=np.
Emulated=Emulowany
Extracting=Rozpakowywanie
Folder to save the LibreELEC image to=Katalog, do którego zostanie zapisany obraz LibreELEC
Folder to save the OpenELEC image to=Katalog, do którego zostanie zapisany obraz OpenELEC
Form View=Widok formularza
free=wolne
Graphics Card=Karta graficzna
Graphics ROM BIOS=BIOS karty graficznej
Graphics=Grafika
Host Passthrough=Bezpośrdnie przekazanie do hosta
Hyperv tweaks for Windows=Ulepszenia hyperV dla Windows
Hyper-V=Hyper-V
i440fx will work for most=i440fx będzie działać dla większości
Icon=Ikona
Initial=Wstępny
Invalid VM to edit=Nieprawidłowa maszyna wirtualna do edycji
ISO storage path doesnt exist=Ścieżka dostęu do katalogu przechowywania ISO nie istnieje 
ISO storage path was empty=ścieżka dostępu do katalogu przechowywania ISO była pusta
keyboard for VNC=klawiatura dla VNC
LibreELEC Version=Wersja LibreELEC
LibreELEC=LibreELEC
Libvirt Service failed to start=Usługa libvirt nie uruchomiła się pomyślnie
Logical CPUs=Procesory logiczne
Machine=Maszyna
Manual=Instrukcja
Max=Maksimum
MD5 verification failed, your download is incomplete or corrupted=Weryfikacja MD5 była niepomyślna, pobrane pliki są niekompletne lub uszkodzone
mount tag inside vm=
My Workstation=Moja stacja robocza
name of mount tag inside vm=
Name of virtual machine=Nazwa wirtualnej maszyny
Network Bridge=Most sieciowy
Network MAC=Adres MAC
No Virtual Machines installed=Brak zainstalowanych maszyn wirtualnych
None available=Żadna nie jest dostępna
Not enough free space, need at least=Brak wolnego miejsca, potrzeba co najmniej
Not running=Nieuruchomiona
OpenELEC Version=Wersja OpenELEC
OpenELEC=OpenELEC
OS Install CDRom Bus=Szyna płyty instalacyjnej systemu operacyjnego
OS Install ISO=Obraz ISO systemu operacyjnego
Other PCI Devices=Inne urządzenia PCI
OVMF requires a UEFI-compatable OS=OVMF wymaga systemu operacyjnego kompatybilnego z UEFI
OVMF=OVMF
password for VNC=hasło do VNC
path of Unraid share=ścieżka do udziału Unraid
path on Unraid share to save LibreELEC settings=Ścieżka do udziału Unraid w której zostaną zapisane ustawienia LibreELEC
path on Unraid share to save OpenELEC settings=Ścieżka do udziału Unraid w której zostaną zapisane ustawienia OpenELEC
Path to ROM BIOS file=Ścieżka do pliku ROM BIOS
Please choose a folder the LibreELEC image will download to=Wybierz katalog do którego zostanie pobrany obraz LibreELEC
Please choose a folder the OpenELEC image will download to=Wybierz katalog do którego zostanie pobrany obraz OpenELEC
Primary=Podstawowy
Q35 for a newer machine model with PCIE=Q35 dla nowszej maszyny z PCIE=Q35
QEMU64=QEMU64
random mac, you can supply your own=losowy adres sprzętowy, możesz podać własny
re-generate random mac address=regeneruj losowy adres sprzętowy
Remove LibreELEC image=Usuń obraz LibreELEC
Remove OpenELEC image=Usuń obraz OpenELEC
Remove this LibreELEC file=Usuń ten plik LibreELEC
Remove this OpenELEC file=Usuń ten plik OpenELEC
SeaBIOS will work for most=SeaBIOS będzie działał dla większości
SeaBIOS=SeaBIOS
Select the BIOS=Wybierz BIOS
Select the LibreELEC version to use=Wybierz żądaną wersję LibreELEC
Select the machine model=Wybierz model maszyny
Select the OpenELEC version to use=Wybierz żądaną wersję OpenELEC
Select the USB Controller to emulate=Wybierz emulowany kontroler USB
Separate sub-folder and image will be created based on Name=Osobny katalog lub podkatalog oraz obraz zostaną utworzone bazując na Nazwie
shares=udziały
Some OSes wont support USB3=Niektóre systemu operacyjne nie wspierają USB3
Sound Card=Karta dźwiękowa
Start All=Uruchom wszystkie
Start VM after creation=Po jej utworzeni,uruchom maszynę wirtualną
Stop All=Zatrzymaj wszystkie
Toggle VM autostart=Przełącz autouruchamianie maszyn wirtualnych
type of storage image=typ obrazu
Unknown action=Nieznana akcja
Unknown version=Nieznana wersja
Unraid Mount tag=
Unraid Share=Udział Unraid
Updating=Aktualizuję
USB Controller=Kontroler USB
USB Devices=Urządzenia USB
vDisk Bus=Szyna vDisk
vDisk Location=Lokalizacja vDisk
vDisk Size=Rozmiar vDisk
vDisk Type=Typ vDisk
vDisks=vDiski
video for VNC=wideo dla VNC
VirtIO Drivers CDRom Bus=Szyna płyty sterowników virtio
VirtIO Drivers ISO=Obraz sterowników virtio
Virtual Machines=Maszyny wirtualne
VM creation error=Błąd tworzenia maszyny wirtualnej
VM image deletion error=Błąd usuwania maszyny wirtualnej
VNC Keyboard=Klawiatura VNC
VNC Password=Hasło VNC
VNC Video Driver=Sterownik graficzny VNC
VNC=VNC
Wasnt able to stop the process=Nie można było zatrzymać procesu
Windows 7XP=Windows 7/XP
Windows 82012, newer Linux distros=Windows 8/2012, nowsze dystrybucje Linuxa
XML View=Widok XML